NO ./path_to_the_north_texture
SO ./path_to_the_south_texture
EA ./path_to_the_east_texture
WE ./path_to_the_west_texture
F 220,100,55
C 225,30,77

111     1111111111111111111111111 
        1000000000011111000000001
        10110000011100000000000011
        100100000000000000000000001
1111111110110000011100000000000011
100000000011000001110111111111111
111101111111110111100000010001
11110111111111011101010010001
11000000110101011010011000101
1111111111111111 111111111111
10000000000000001000000010001
100000000000000001101010010001
11000001110101011111011110N0111
11110111 1110101 101111010001
11111111111111111111111111111